R 800 800
F 150,150,0
C 80,80,80

SO ./pics/wall_S.xpm
S ./pics/barrel.xpm
NO ./pics/wall_N.xpm   
EA ./pics/wall_E.xpm
WE ./pics/wall_W.png

                              111
        1111111111111111111111101
        1000000000110000000111211
        1011000000000000020110001
        102100000W000000000110001
111111111011000000000000000000001
100000000011000001110111111111111
11110111111111011100000010001
11110111111111011101010010001
11000000110101011100000012001
10022200000000001100000000001
10020200000000001101010010001
112002011101010111110111100111
11110111 1110101 101111010001
11111111 1111111 111111111111
