R 650 600
F 150,150,150
C 80,80,80

SO ./pics/colorstone.png
S ./pics/barrel.png
NO ./pics/bluestone.png   
EA ./pics/redbrick.xpm
WE ./pics/mossy 1.png

11111111111111
11000111100001
100000000000011
120000000000001
120000000011111
1100000W000021
100000000000011
10000011111111
100000000000011
100020000000001
122222222222211
11111111111111  11