R 800 700
F 150,150,150
C 80,80,80

SO ./pics/greystone.xpm
S ./pics/barrel.xpm
NO ./pics/greystone.xpm
EA./pics/redbrick.xpm
WE./pics/purplestone.xpm

1111111111111
11111100001
10000000001
10002000001
100000000011
10000000000111
10000000001111
1000000W0000211
1000000000000211
100000111111111111
100000011
100000001
122222221
1111111111
